TTTTTTTTTTTTTTTTTTTT
TFFFFTFFFFFFFFTFFFFT
TFTTFTFTTTTTTFTFTTFT
TFTFFFFFFFFFFFFFFTFT
TFTFTTFTTFFTTFTTFTFT
TFFFFFFTFFFFTFFFFFFT
TFTFTTFTTTTTTFTTFTFT
TFTFFFFFFFFFFFFFFTFT
TFTTFTFTTTTTTFTFTTFT
TFFFFTFFFFFFFFTFFFFT
TTTTTTTTTTTTTTTTTTTT
