%%%%%%%%%%%%%%%%%%%%
%      %    %     .%
% %%   %%  %%   %% %
% %  %        %  % %
% %% % %%%%%% % %% %
%        P         %
%%%%%%%%%%%%%%%%%%%%
